21 21 
10 12
12 11 11 11 11 11 11 11 11 11 11 11 11 11 11 11 11 11 11 11 12
10 10 10 10 10 10 10 10 10 10 10 10 10 10 10 10 10 10 10 10 10
12 11 11 12 10 12 11 12 10 12 11 12 10 12 11 12 10 12 11 11 12
12 10 10 10 10 10 10 12 10 10 10 10 10 12 10 10 10 10 10 10 12
12 10 12 12 10 12 10 12 11 11 11 11 11 12 10 12 10 12 12 10 12
12 10 12 12 10 12 10 10 10 10 10 10 10 10 10 12 10 12 12 10 12
12 10 10 10 10 12 10 12 11 12 10 12 11 12 10 12 10 10 10 10 12
12 10 12 12 10 12 10 10 10 10 10 10 10 10 10 12 10 12 12 10 12
12 10 12 12 10 12 12 10 12 11 13 11 12 10 12 12 10 12 12 10 12
12 10 12 10 10 10 12 10 12 12 10 12 12 10 12 10 10 10 12 10 12
12 10 10 10 12 10 10 10 12 12 10 12 12 10 10 10 12 10 10 10 12
12 10 12 10 10 10 12 10 12 11 11 11 12 10 12 10 10 10 12 10 12
12 10 12 12 10 12 10 10 10 10 10 10 10 10 10 12 10 12 12 10 12
12 10 12 12 10 12 10 12 11 12 10 12 11 12 10 12 10 12 12 10 12
12 10 10 10 10 12 10 10 10 10 10 10 10 10 10 12 10 10 10 10 12
12 10 12 12 10 12 10 12 11 11 11 11 11 12 10 12 10 12 12 10 12
12 10 12 12 10 12 10 12 10 10 10 10 10 12 10 12 10 12 12 10 12
12 10 10 10 10 10 10 12 10 12 11 12 10 12 10 10 10 10 10 10 12
12 11 11 12 10 12 11 12 10 12 11 12 10 12 11 12 10 12 11 11 12
10 10 10 10 10 10 10 10 10 10 10 10 10 10 10 10 10 10 10 10 10
12 11 11 11 11 11 11 11 11 11 11 11 11 11 11 11 11 11 11 11 12