21 21 
10 13
6 4 4 4 4 4 4 4 4 4 4 4 4 4 4 4 4 4 4 4 6
6 9 9 9 9 9 9 9 9 9 9 9 9 9 9 9 9 9 9 9 6
6 9 6 4 4 4 6 9 6 4 4 4 6 9 6 4 4 4 6 9 6
6 9 9 9 9 9 9 9 9 9 9 9 9 9 9 9 9 9 9 9 6
6 9 6 9 6 4 4 4 4 6 9 6 4 4 4 4 6 9 6 9 6
6 9 6 9 6 9 9 9 9 9 9 9 9 9 9 9 6 9 6 9 6
6 9 9 9 6 9 6 4 4 6 9 6 4 4 6 9 6 9 9 9 6
6 9 6 9 9 9 6 9 9 9 9 9 9 9 6 9 9 9 6 9 6
9 9 6 9 6 9 6 9 5 4 8 4 6 9 6 9 6 9 6 9 9
6 9 6 9 6 9 6 9 6 6 9 6 5 9 6 9 6 9 6 9 6
6 9 9 9 6 9 6 9 5 6 9 6 6 9 6 9 6 9 9 9 6
6 9 6 9 6 9 9 9 6 6 9 6 5 9 9 9 6 9 6 9 6
6 9 6 9 6 9 6 9 5 4 4 5 5 9 6 9 6 9 6 9 6
6 9 6 9 9 9 6 9 9 9 9 9 9 9 6 9 9 9 6 9 6
6 9 9 9 6 9 6 4 4 6 9 6 4 4 6 9 6 9 9 9 6
6 9 6 9 6 9 9 9 9 9 9 9 9 9 9 9 6 9 6 9 6
6 9 6 9 6 4 4 4 4 6 9 6 4 4 4 4 6 9 6 9 6
6 9 9 9 9 9 9 9 9 9 9 9 9 9 9 9 9 9 9 9 6
6 9 6 4 4 4 6 9 6 4 4 4 6 9 6 4 4 4 6 9 6
6 9 9 9 9 9 9 9 9 9 9 9 9 9 9 9 9 9 9 9 6
6 4 4 4 4 4 4 4 4 4 4 4 4 4 4 4 4 4 4 4 6